1 1 1 1 1 1 1 1 1 1 1 1 1 1 1 1
1 0 1 2 3 4 5 0 0 0 0 0 0 0 0 1
1 0 1 0 1 1 1 1 1 1 1 1 1 1 0 1
1 0 1 0 1 0 0 0 0 0 0 0 0 1 0 1
1 0 1 0 1 0 1 1 1 1 1 1 0 1 0 1
1 0 1 0 1 0 1 2 2 3 4 1 0 1 0 1
1 0 1 0 1 0 0 0 0 0 4 1 0 1 0 1
1 0 1 0 1 1 1 1 1 1 1 1 0 1 0 1
1 0 1 0 0 0 0 0 0 0 0 0 0 1 0 1
1 0 1 1 1 1 1 1 1 1 1 1 1 1 0 1
1 0 0 0 0 0 0 0 0 0 0 0 0 0 0 1
1 1 1 1 1 1 1 1 1 1 1 1 1 1 1 1