31 31 31 31 31 31 31 31 31 31 31 31 31 31 31 31 31 31 31 31 31 31 31 31 31 31 31 31 31 31 31 31 31 31 31 31 31 31 31 31 31 31 31 31 31 31 31 31 31 31
31 31 31 31 31 31 31 31 31 31 31 31 31 31 31 31 31 31 31 31 31 31 31 31 31 31 31 31 31 31 31 31 31 31 31 31 31 31 31 32 31 31 31 31 31 31 31 31 31 31
31 31 31 31 31 31 31 31 31 31 31 31 31 31 31 31 31 31 31 31 31 31 31 31 31 31 31 31 31 31 31 31 31 31 31 31 31 31 31 31 31 31 32 31 31 31 31 31 31 31
31 31 31 31 31 31 31 31 31 31 31 31 31 31 31 31 31 31 31 31 31 31 31 31 31 31 31 31 31 31 31 31 31 31 32 31 31 31 31 31 31 31 31 31 31 31 31 31 31 31
31 31 31 31 31 31 31 31 31 31 31 31 31 31 31 31 31 31 31 31 31 31 31 31 31 31 31 31 31 31 31 31 31 31 31 31 31 31 32 31 31 32 31 31 31 31 31 31 31 31
31 31 31 31 31 31 31 31 31 31 31 31 31 31 31 32 31 31 31 31 31 31 31 31 32 31 31 31 31 31 31 31 31 31 31 31 31 31 31 31 31 31 31 31 32 31 32 31 31 31
31 31 31 31 31 31 31 31 31 31 31 31 32 31 31 31 31 31 31 32 31 31 31 31 31 31 31 31 31 31 32 31 31 41 39 39 39 39 39 39 42 31 31 31 31 31 31 31 31 31
31 31 31 31 31 31 32 31 31 31 32 31 31 31 41 39 39 39 39 39 39 39 39 39 39 39 39 39 39 39 39 39 39 40 24 22 22 22 22 25 38 42 31 31 31 31 31 31 31 31
31 31 31 31 31 31 31 41 39 39 39 39 39 39 40 29 29 29 29 29 29 29 29 24 22 22 22 22 22 22 22 22 22 22 23 15 15 15 15 21 25 36 31 31 31 31 31 31 31 31
31 31 31 31 31 31 31 37 30 30 30 30 30 29 29 29 29 29 29 29 29 29 24 23 15 15 15 15 15 15 15 15 15 15 15 15 15 15 15 15 19 36 31 31 31 31 31 31 31 31
31 31 31 31 31 31 31 37 30 10 10 10 30 29 29 29 29 29 29 29 29 29 20 15 15 15 15 15 15 15 15 15 15 15 15 15 15 15 15 15 19 36 31 31 31 32 31 31 31 31
31 31 31 31 32 31 31 37 30 10 10 10 30 29 29 29 29 29 29 29 29 29 20 15 15 15 15 15 15 15 15 15 15 15 15 15 15 15 15 15 19 36 31 31 31 31 31 31 31 31
31 31 31 31 31 31 31 37 30 10 10 10 30 29 29 29 29 29 29 29 29 29 20 15 15 15 15 16 17 17 17 17 17 17 18 15 15 15 15 15 19 36 31 31 31 31 31 31 31 31
31 31 31 31 31 31 31 37 30 30 10 30 30 29 29 29 29 29 29 29 29 29 20 15 15 15 16 27 12 12 12 13 12 12 26 18 15 15 15 16 27 36 31 31 31 31 31 31 31 31
31 31 31 31 31 31 31 43 35 12 12 12 29 29 29 29 29 29 29 29 29 29 20 15 15 15 19 13 33 34 34 34 34 35 13 20 15 15 15 19 33 44 31 32 31 31 32 31 31 31
31 31 31 31 31 31 31 41 40 24 22 25 29 29 29 29 29 29 29 29 29 29 20 15 15 15 19 12 36 31 31 31 31 37 12 20 15 15 15 19 36 31 31 31 31 31 31 31 31 31
31 31 31 31 31 31 31 37 12 20 15 19 29 29 29 29 29 29 29 29 29 12 20 15 15 15 19 12 36 31 31 32 31 37 12 20 15 15 15 19 36 31 31 31 31 31 31 31 31 31
31 31 31 31 31 32 31 37 12 20 15 19 29 29 29 29 29 29 29 29 29 13 20 15 15 15 19 12 36 31 31 31 31 37 12 20 15 15 15 19 38 42 31 31 32 31 31 31 31 31
31 31 31 31 31 31 31 37 12 20 15 19 29 29 29 29 29 29 29 29 12 12 20 15 15 15 19 12 36 31 32 31 31 37 13 20 15 15 15 19 12 36 31 31 31 31 31 31 31 31
31 31 31 31 31 31 31 37 12 20 15 19 29 29 29 29 29 29 29 12 12 12 20 15 15 15 19 12 36 31 31 31 31 37 12 20 15 15 15 19 12 36 31 31 31 31 31 31 31 31
31 31 31 31 31 31 31 37 12 20 15 19 29 29 29 29 29 29 29 13 12 12 20 15 15 15 19 13 38 39 39 39 39 40 12 20 15 15 15 19 12 36 31 31 31 31 31 31 31 31
31 31 31 31 31 31 31 37 12 20 15 19 29 29 29 29 29 29 12 12 12 13 26 17 17 17 27 12 12 12 12 13 12 12 12 20 15 15 15 19 12 36 31 31 31 31 31 31 31 31
31 31 31 31 31 31 32 37 12 20 15 19 29 29 29 29 29 24 22 22 22 25 12 12 12 12 12 24 22 22 22 22 22 22 22 23 15 15 15 19 12 36 31 32 31 31 31 31 31 31
31 31 31 31 31 31 31 37 12 20 15 19 29 29 29 29 12 20 15 15 15 19 12 12 12 12 13 20 15 15 15 15 15 15 15 15 15 15 15 19 12 36 31 31 31 32 31 31 31 31
31 31 31 31 31 31 31 37 12 20 15 19 29 29 29 12 12 20 15 15 15 19 12 12 13 12 12 20 15 15 15 15 15 15 15 15 15 15 15 19 12 36 31 31 31 31 31 31 31 31
31 31 31 31 31 31 31 37 12 20 15 19 29 29 29 12 12 20 15 15 15 19 12 12 12 12 12 20 15 15 15 15 15 15 15 15 15 15 15 19 12 36 31 31 31 31 31 31 31 31
31 31 31 31 31 31 31 43 35 20 15 19 29 29 29 12 12 12 17 17 17 27 12 13 12 12 12 26 17 17 17 17 17 17 17 18 15 15 15 19 12 36 31 31 31 31 31 31 31 31
31 31 31 31 31 32 31 31 37 26 17 27 29 29 29 12 12 29 29 33 34 35 24 22 22 22 25 29 29 29 29 29 29 29 13 20 15 15 15 19 12 36 31 31 31 31 31 31 31 31
31 31 31 31 31 31 31 31 37 12 12 12 29 29 29 29 12 29 33 44 31 37 20 15 15 15 19 29 29 29 29 29 29 29 29 20 15 15 15 19 12 36 31 31 32 31 31 31 31 31
31 31 31 31 31 31 31 41 40 29 12 29 29 29 29 29 12 29 36 31 31 37 20 15 15 15 19 29 29 29 29 29 29 29 29 20 15 15 15 19 12 36 31 31 31 31 31 31 31 31
31 31 31 31 31 31 31 37 29 29 12 29 29 29 29 29 12 29 36 31 31 37 20 15 15 15 19 29 29 29 13 12 12 29 29 20 15 15 15 19 12 36 31 31 31 31 31 31 31 31
31 31 31 31 31 31 31 37 29 29 12 29 29 29 29 29 12 29 38 42 31 37 20 15 15 15 19 29 29 29 12 12 13 12 12 20 15 15 15 19 12 36 31 31 31 31 31 31 31 31
31 31 31 31 31 31 31 37 29 29 12 29 29 29 29 29 12 29 29 36 31 37 20 15 15 15 19 29 29 29 12 12 12 12 13 20 15 15 15 19 12 36 31 31 31 31 32 31 31 31
31 31 31 31 31 31 32 37 29 29 12 29 29 29 29 29 12 29 29 36 31 37 20 15 15 15 19 29 29 29 29 13 12 12 12 20 15 15 15 19 12 36 31 31 31 31 31 31 31 31
31 31 31 31 31 31 31 37 29 29 12 12 12 12 12 12 12 29 29 36 41 40 20 15 15 15 19 13 29 29 29 29 12 12 24 23 15 15 15 19 12 36 31 31 31 31 31 31 31 31
31 31 31 31 31 31 31 43 35 29 29 29 29 29 29 29 29 29 33 44 37 24 23 15 15 15 21 22 22 22 22 22 22 22 23 15 15 15 15 19 12 36 31 31 31 31 31 31 31 31
31 31 31 31 31 31 31 31 43 35 29 29 29 29 29 29 29 33 44 31 37 20 15 15 15 15 15 15 15 15 15 15 15 15 15 15 15 15 15 19 33 44 31 32 31 31 31 31 31 31
31 31 31 31 31 31 31 31 31 43 34 34 34 34 34 34 34 44 31 31 37 20 15 15 15 15 15 15 15 15 15 15 15 15 15 15 15 15 15 19 36 31 31 31 31 31 31 31 31 31
31 31 31 31 31 31 31 31 32 31 31 31 31 31 31 31 31 31 31 31 37 20 15 15 15 15 15 15 15 15 15 15 15 15 15 15 15 15 16 27 36 31 31 31 31 31 31 31 31 31
31 31 31 31 31 31 31 31 31 31 31 32 31 31 32 31 31 32 31 31 37 26 18 15 15 15 16 17 17 17 17 17 17 17 17 17 17 17 27 33 44 31 31 31 31 31 31 31 31 31
31 31 31 31 31 31 31 31 31 31 31 31 31 31 31 31 31 31 31 31 43 35 26 17 17 17 27 33 34 34 34 34 34 34 34 34 34 34 34 44 31 31 31 31 31 32 31 31 31 31
31 31 31 31 31 31 31 31 31 31 31 31 31 31 31 32 31 31 31 31 31 43 34 34 34 34 34 44 31 31 31 31 31 31 31 31 31 31 31 31 31 32 31 31 31 31 31 31 31 31
31 31 31 31 31 31 31 31 31 31 31 31 31 31 31 31 31 31 31 31 31 31 31 31 31 31 31 31 31 31 31 31 31 32 31 31 31 31 31 31 31 31 31 31 31 31 31 31 31 31
31 31 31 31 31 31 31 31 31 31 31 31 31 31 31 31 31 31 31 32 31 31 32 31 31 31 31 31 31 31 31 31 31 31 31 31 31 31 31 31 31 31 31 31 31 31 31 31 31 31
31 31 31 31 31 31 31 31 31 31 31 32 31 31 31 31 31 31 31 31 31 31 31 31 31 31 31 31 31 32 31 31 31 31 31 31 31 31 32 31 31 31 31 31 31 31 31 31 31 31
31 31 31 31 31 31 31 31 31 31 31 31 31 31 31 31 31 31 31 31 31 31 31 31 31 31 31 31 31 31 31 31 31 31 31 31 31 31 31 31 31 31 31 31 31 31 31 31 31 31
31 31 31 31 31 31 31 31 31 31 31 31 31 31 31 31 31 31 31 31 31 31 31 32 31 31 31 31 31 31 31 31 31 31 31 31 31 31 31 31 31 31 31 31 31 31 31 31 31 31
31 31 31 31 31 31 31 31 31 31 31 31 31 31 31 31 31 31 31 31 31 31 31 31 31 31 31 31 31 31 31 31 31 31 31 31 31 31 31 31 31 31 31 31 31 31 31 31 31 31
31 31 31 31 31 31 31 31 31 31 31 31 31 31 31 31 31 31 31 31 31 31 31 31 31 31 31 31 31 31 31 31 31 31 31 31 31 31 31 31 31 31 31 31 31 31 31 31 31 31
11 12 13 14 15 16 17 18 19 20 21 22 23 24 25 26 27 28 29 30 31 32 33 34 35 36 37 38 39 40 41 42 43 44 45 46 47 48 49 50 11 12 13 14 15 16 17 18 19 20